Id,ActivityDate,TotalSteps,TotalDistance,SedentaryMinutes,Calories,ActiveMinutes,TotalLoggedMinutes,indexOfWeek,dayNames
1503960366,"2016-04-12 00:00:00",13162,8.5,728,1985,366,1094,3,Tuesday
1503960366,"2016-04-13 00:00:00",10735,6.97,776,1797,257,1033,4,Wednesday
1503960366,"2016-04-14 00:00:00",10460,6.74,1218,1776,222,1440,5,Thursday
1503960366,"2016-04-15 00:00:00",9762,6.28,726,1745,272,998,6,Friday
1503960366,"2016-04-16 00:00:00",12669,8.16,773,1863,267,1040,7,Saturday
1503960366,"2016-04-17 00:00:00",9705,6.48,539,1728,222,761,1,Sunday
1503960366,"2016-04-18 00:00:00",13019,8.59,1149,1921,291,1440,2,Monday
1503960366,"2016-04-19 00:00:00",15506,9.88,775,2035,345,1120,3,Tuesday
1503960366,"2016-04-20 00:00:00",10544,6.68,818,1786,245,1063,4,Wednesday
1503960366,"2016-04-21 00:00:00",9819,6.34,838,1775,238,1076,5,Thursday
1503960366,"2016-04-22 00:00:00",12764,8.13,1217,1827,223,1440,6,Friday
1503960366,"2016-04-23 00:00:00",14371,9.04,732,1949,324,1056,7,Saturday
1503960366,"2016-04-24 00:00:00",10039,6.41,709,1788,282,991,1,Sunday
1503960366,"2016-04-25 00:00:00",15355,9.8,814,2013,303,1117,2,Monday
1503960366,"2016-04-26 00:00:00",13755,8.79,833,1970,333,1166,3,Tuesday
1503960366,"2016-04-27 00:00:00",18134,12.21,1108,2159,332,1440,4,Wednesday
1503960366,"2016-04-28 00:00:00",13154,8.53,782,1898,265,1047,5,Thursday
1503960366,"2016-04-29 00:00:00",11181,7.15,815,1837,271,1086,6,Friday
1503960366,"2016-04-30 00:00:00",14673,9.25,712,1947,303,1015,7,Saturday
1503960366,"2016-05-01 00:00:00",10602,6.81,730,1820,314,1044,1,Sunday
1503960366,"2016-05-02 00:00:00",14727,9.71,798,2004,333,1131,2,Monday
1503960366,"2016-05-03 00:00:00",15103,9.66,816,1990,328,1144,3,Tuesday
1503960366,"2016-05-04 00:00:00",11100,7.15,1179,1819,261,1440,4,Wednesday
1503960366,"2016-05-05 00:00:00",14070,8.9,857,1959,319,1176,5,Thursday
1503960366,"2016-05-06 00:00:00",12159,8.03,754,1896,319,1073,6,Friday
1503960366,"2016-05-07 00:00:00",11992,7.71,833,1821,258,1091,7,Saturday
1503960366,"2016-05-08 00:00:00",10060,6.58,574,1740,255,829,1,Sunday
1503960366,"2016-05-09 00:00:00",12022,7.72,835,1819,263,1098,2,Monday
1503960366,"2016-05-10 00:00:00",12207,7.77,746,1859,291,1037,3,Tuesday
1503960366,"2016-05-11 00:00:00",12770,8.13,669,1783,310,979,4,Wednesday
1503960366,"2016-05-12 00:00:00",0,0,1440,0,0,1440,5,Thursday
1624580081,"2016-04-12 00:00:00",8163,5.31,1294,1432,146,1440,3,Tuesday
1624580081,"2016-04-13 00:00:00",7007,4.55,1292,1411,148,1440,4,Wednesday
1624580081,"2016-04-14 00:00:00",9107,5.92,1204,1572,236,1440,5,Thursday
1624580081,"2016-04-15 00:00:00",1510,0.98,1344,1344,96,1440,6,Friday
1624580081,"2016-04-16 00:00:00",5370,3.49,1264,1463,176,1440,7,Saturday
1624580081,"2016-04-17 00:00:00",6175,4.06,1276,1554,164,1440,1,Sunday
1624580081,"2016-04-18 00:00:00",10536,7.41,1214,1604,226,1440,2,Monday
1624580081,"2016-04-19 00:00:00",2916,1.9,1299,1435,141,1440,3,Tuesday
1624580081,"2016-04-20 00:00:00",4974,3.23,1289,1446,151,1440,4,Wednesday
1624580081,"2016-04-21 00:00:00",6349,4.13,1254,1467,186,1440,5,Thursday
1624580081,"2016-04-22 00:00:00",4026,2.62,1241,1470,199,1440,6,Friday
1624580081,"2016-04-23 00:00:00",8538,5.55,1213,1562,227,1440,7,Saturday
1624580081,"2016-04-24 00:00:00",6076,3.95,1221,1617,219,1440,1,Sunday
1624580081,"2016-04-25 00:00:00",6497,4.22,1238,1492,202,1440,2,Monday
1624580081,"2016-04-26 00:00:00",2826,1.84,1300,1402,140,1440,3,Tuesday
1624580081,"2016-04-27 00:00:00",8367,5.44,1233,1670,207,1440,4,Wednesday
1624580081,"2016-04-28 00:00:00",2759,1.79,1320,1401,120,1440,5,Thursday
1624580081,"2016-04-29 00:00:00",2390,1.55,1290,1404,150,1440,6,Friday
1624580081,"2016-04-30 00:00:00",6474,4.3,1182,1655,258,1440,7,Saturday
1624580081,"2016-05-01 00:00:00",36019,28.03,1020,2690,420,1440,1,Sunday
1624580081,"2016-05-02 00:00:00",7155,4.93,1261,1497,179,1440,2,Monday
1624580081,"2016-05-03 00:00:00",2100,1.37,1344,1334,96,1440,3,Tuesday
1624580081,"2016-05-04 00:00:00",2193,1.43,1322,1368,118,1440,4,Wednesday
1624580081,"2016-05-05 00:00:00",2470,1.61,1323,1370,117,1440,5,Thursday
1624580081,"2016-05-06 00:00:00",1727,1.12,1338,1341,102,1440,6,Friday
1624580081,"2016-05-07 00:00:00",2104,1.37,1258,1474,182,1440,7,Saturday
1624580081,"2016-05-08 00:00:00",3427,2.23,1288,1427,152,1440,1,Sunday
1624580081,"2016-05-09 00:00:00",1732,1.13,1349,1328,91,1440,2,Monday
1624580081,"2016-05-10 00:00:00",2969,1.93,1301,1393,139,1440,3,Tuesday
1624580081,"2016-05-11 00:00:00",3134,2.04,1328,1359,112,1440,4,Wednesday
1624580081,"2016-05-12 00:00:00",2971,1.93,890,1002,107,997,5,Thursday
1644430081,"2016-04-12 00:00:00",10694,7.77,1131,3199,309,1440,3,Tuesday
1644430081,"2016-04-13 00:00:00",8001,5.82,1259,2902,181,1440,4,Wednesday
1644430081,"2016-04-14 00:00:00",11037,8.02,1125,3226,315,1440,5,Thursday
1644430081,"2016-04-15 00:00:00",5263,3.83,1263,2750,177,1440,6,Friday
1644430081,"2016-04-16 00:00:00",15300,11.12,1135,3493,305,1440,7,Saturday
1644430081,"2016-04-17 00:00:00",8757,6.37,1212,3011,228,1440,1,Sunday
1644430081,"2016-04-18 00:00:00",7132,5.19,1271,2806,169,1440,2,Monday
1644430081,"2016-04-19 00:00:00",11256,8.18,1099,3300,341,1440,3,Tuesday
1644430081,"2016-04-20 00:00:00",2436,1.77,1315,2430,125,1440,4,Wednesday
1644430081,"2016-04-21 00:00:00",1223,0.89,1402,2140,38,1440,5,Thursday
1644430081,"2016-04-22 00:00:00",3673,2.67,1354,2344,86,1440,6,Friday
1644430081,"2016-04-23 00:00:00",6637,4.83,1265,2677,175,1440,7,Saturday
1644430081,"2016-04-24 00:00:00",3321,2.41,1351,2413,89,1440,1,Sunday
1644430081,"2016-04-25 00:00:00",3580,2.6,1337,2497,103,1440,2,Monday
1644430081,"2016-04-26 00:00:00",9919,7.21,1165,3123,275,1440,3,Tuesday
1644430081,"2016-04-27 00:00:00",3032,2.2,1322,2489,118,1440,4,Wednesday
1644430081,"2016-04-28 00:00:00",9405,6.84,1157,3108,283,1440,5,Thursday
1644430081,"2016-04-29 00:00:00",3176,2.31,1193,2498,120,1313,6,Friday
1644430081,"2016-04-30 00:00:00",18213,13.24,816,3846,482,1298,7,Saturday
1644430081,"2016-05-01 00:00:00",6132,4.46,908,2696,173,1081,1,Sunday
1644430081,"2016-05-02 00:00:00",3758,2.73,682,2580,156,838,2,Monday
1644430081,"2016-05-03 00:00:00",12850,9.34,1115,3324,325,1440,3,Tuesday
1644430081,"2016-05-04 00:00:00",2309,1.68,1388,2222,52,1440,4,Wednesday
1644430081,"2016-05-05 00:00:00",4363,3.19,1341,2463,99,1440,5,Thursday
1644430081,"2016-05-06 00:00:00",9787,7.12,1054,3328,386,1440,6,Friday
1644430081,"2016-05-07 00:00:00",13372,9.72,1139,3404,301,1440,7,Saturday
1644430081,"2016-05-08 00:00:00",6724,4.89,991,2987,295,1286,1,Sunday
1644430081,"2016-05-09 00:00:00",6643,4.83,1099,3008,341,1440,2,Monday
1644430081,"2016-05-10 00:00:00",9167,6.66,1254,2799,186,1440,3,Tuesday
1644430081,"2016-05-11 00:00:00",1329,0.97,713,1276,49,762,4,Wednesday
1844505072,"2016-04-12 00:00:00",6697,4.43,1101,2030,339,1440,3,Tuesday
1844505072,"2016-04-13 00:00:00",4929,3.26,1192,1860,248,1440,4,Wednesday
1844505072,"2016-04-14 00:00:00",7937,5.25,843,2130,373,1216,5,Thursday
1844505072,"2016-04-15 00:00:00",3844,2.54,527,1725,176,703,6,Friday
1844505072,"2016-04-16 00:00:00",3414,2.26,1293,1657,147,1440,7,Saturday
1844505072,"2016-04-17 00:00:00",4525,2.99,1231,1793,209,1440,1,Sunday
1844505072,"2016-04-18 00:00:00",4597,3.04,1211,1814,229,1440,2,Monday
1844505072,"2016-04-19 00:00:00",197,0.13,1430,1366,10,1440,3,Tuesday
1844505072,"2016-04-20 00:00:00",8,0.01,1439,1349,1,1440,4,Wednesday
1844505072,"2016-04-21 00:00:00",8054,5.32,1117,2062,323,1440,5,Thursday
1844505072,"2016-04-22 00:00:00",5372,3.55,1220,1827,220,1440,6,Friday
1844505072,"2016-04-23 00:00:00",3570,2.36,1301,1645,139,1440,7,Saturday
1844505072,"2016-04-24 00:00:00",0,0,1440,1347,0,1440,1,Sunday
1844505072,"2016-04-25 00:00:00",0,0,1440,1347,0,1440,2,Monday
1844505072,"2016-04-26 00:00:00",0,0,1440,1347,0,1440,3,Tuesday
1844505072,"2016-04-27 00:00:00",4,0,1439,1348,1,1440,4,Wednesday
1844505072,"2016-04-28 00:00:00",6907,4.57,1138,1992,302,1440,5,Thursday
1844505072,"2016-04-29 00:00:00",4920,3.25,1082,1856,247,1329,6,Friday
1844505072,"2016-04-30 00:00:00",4014,2.67,218,1763,184,402,7,Saturday
1844505072,"2016-05-01 00:00:00",2573,1.7,585,1541,82,667,1,Sunday
1844505072,"2016-05-02 00:00:00",0,0,1440,1348,0,1440,2,Monday
1844505072,"2016-05-03 00:00:00",4059,2.68,1256,1742,184,1440,3,Tuesday
1844505072,"2016-05-04 00:00:00",2080,1.37,1353,1549,87,1440,4,Wednesday
1844505072,"2016-05-05 00:00:00",2237,1.48,1320,1589,120,1440,5,Thursday
1844505072,"2016-05-06 00:00:00",44,0.03,1438,1351,2,1440,6,Friday
1844505072,"2016-05-07 00:00:00",0,0,1440,1347,0,1440,7,Saturday
1844505072,"2016-05-08 00:00:00",0,0,1440,1347,0,1440,1,Sunday
1844505072,"2016-05-09 00:00:00",0,0,1440,1347,0,1440,2,Monday
1844505072,"2016-05-10 00:00:00",0,0,1440,1347,0,1440,3,Tuesday
1844505072,"2016-05-11 00:00:00",0,0,1440,1347,0,1440,4,Wednesday
1844505072,"2016-05-12 00:00:00",0,0,711,665,0,711,5,Thursday
1927972279,"2016-04-12 00:00:00",678,0.47,734,2220,55,789,3,Tuesday
1927972279,"2016-04-13 00:00:00",356,0.25,986,2151,32,1018,4,Wednesday
1927972279,"2016-04-14 00:00:00",2163,1.5,1292,2383,97,1389,5,Thursday
1927972279,"2016-04-15 00:00:00",980,0.68,941,2221,51,992,6,Friday
1927972279,"2016-04-16 00:00:00",0,0,1440,2064,0,1440,7,Saturday
1927972279,"2016-04-17 00:00:00",0,0,1440,2063,0,1440,1,Sunday
1927972279,"2016-04-18 00:00:00",244,0.17,1423,2111,17,1440,2,Monday
1927972279,"2016-04-19 00:00:00",0,0,1440,2063,0,1440,3,Tuesday
1927972279,"2016-04-20 00:00:00",0,0,1440,2063,0,1440,4,Wednesday
1927972279,"2016-04-21 00:00:00",0,0,1440,2064,0,1440,5,Thursday
1927972279,"2016-04-22 00:00:00",149,0.1,1430,2093,10,1440,6,Friday
1927972279,"2016-04-23 00:00:00",2945,2.04,1295,2499,145,1440,7,Saturday
1927972279,"2016-04-24 00:00:00",2090,1.45,1358,2324,82,1440,1,Sunday
1927972279,"2016-04-25 00:00:00",152,0.11,1303,2100,12,1315,2,Monday
1927972279,"2016-04-26 00:00:00",3761,2.6,1058,2638,192,1250,3,Tuesday
1927972279,"2016-04-27 00:00:00",0,0,1440,2063,0,1440,4,Wednesday
1927972279,"2016-04-28 00:00:00",1675,1.16,1167,2351,95,1262,5,Thursday
1927972279,"2016-04-29 00:00:00",0,0,1440,2063,0,1440,6,Friday
1927972279,"2016-04-30 00:00:00",0,0,1440,2064,0,1440,7,Saturday
1927972279,"2016-05-01 00:00:00",2704,1.87,1355,2411,85,1440,1,Sunday
1927972279,"2016-05-02 00:00:00",3790,2.62,1322,2505,118,1440,2,Monday
1927972279,"2016-05-03 00:00:00",1326,0.92,1413,2195,27,1440,3,Tuesday
1927972279,"2016-05-04 00:00:00",1786,1.24,1353,2338,87,1440,4,Wednesday
1927972279,"2016-05-05 00:00:00",0,0,1440,2063,0,1440,5,Thursday
1927972279,"2016-05-06 00:00:00",2091,1.45,1332,2383,108,1440,6,Friday
1927972279,"2016-05-07 00:00:00",1510,1.04,1392,2229,48,1440,7,Saturday
1927972279,"2016-05-08 00:00:00",0,0,1440,2063,0,1440,1,Sunday
1927972279,"2016-05-09 00:00:00",0,0,1440,2063,0,1440,2,Monday
1927972279,"2016-05-10 00:00:00",0,0,1440,2063,0,1440,3,Tuesday
1927972279,"2016-05-11 00:00:00",0,0,1440,2063,0,1440,4,Wednesday
1927972279,"2016-05-12 00:00:00",0,0,966,1383,0,966,5,Thursday
2022484408,"2016-04-12 00:00:00",11875,8.34,1157,2390,283,1440,3,Tuesday
2022484408,"2016-04-13 00:00:00",12024,8.5,1100,2601,340,1440,4,Wednesday
2022484408,"2016-04-14 00:00:00",10690,7.5,1148,2312,292,1440,5,Thursday
2022484408,"2016-04-15 00:00:00",11034,8.03,1122,2525,318,1440,6,Friday
2022484408,"2016-04-16 00:00:00",10100,7.09,1237,2177,203,1440,7,Saturday
2022484408,"2016-04-17 00:00:00",15112,11.4,1052,2782,388,1440,1,Sunday
2022484408,"2016-04-18 00:00:00",14131,10.07,1078,2770,362,1440,2,Monday
2022484408,"2016-04-19 00:00:00",11548,8.53,1152,2489,288,1440,3,Tuesday
2022484408,"2016-04-20 00:00:00",15112,10.67,1053,2897,387,1440,4,Wednesday
2022484408,"2016-04-21 00:00:00",12453,8.74,1028,3158,412,1440,5,Thursday
2022484408,"2016-04-22 00:00:00",12954,9.33,1105,2638,335,1440,6,Friday
2022484408,"2016-04-23 00:00:00",6001,4.21,1191,2069,249,1440,7,Saturday
2022484408,"2016-04-24 00:00:00",13481,10.28,1161,2529,279,1440,1,Sunday
2022484408,"2016-04-25 00:00:00",11369,8.01,1171,2470,269,1440,2,Monday
2022484408,"2016-04-26 00:00:00",10119,7.19,1086,2793,354,1440,3,Tuesday
2022484408,"2016-04-27 00:00:00",10159,7.13,1119,2463,321,1440,4,Wednesday
2022484408,"2016-04-28 00:00:00",10140,7.12,1123,2296,317,1440,5,Thursday
2022484408,"2016-04-29 00:00:00",10245,7.19,1098,2611,342,1440,6,Friday
2022484408,"2016-04-30 00:00:00",18387,12.91,1043,2732,397,1440,7,Saturday
2022484408,"2016-05-01 00:00:00",10538,7.4,1142,2380,298,1440,1,Sunday
2022484408,"2016-05-02 00:00:00",10379,7.29,1119,2473,321,1440,2,Monday
2022484408,"2016-05-03 00:00:00",12183,8.74,1104,2752,336,1440,3,Tuesday
2022484408,"2016-05-04 00:00:00",11768,8.29,1105,2649,335,1440,4,Wednesday
2022484408,"2016-05-05 00:00:00",11895,8.35,1112,2609,328,1440,5,Thursday
2022484408,"2016-05-06 00:00:00",10227,7.18,1104,2498,336,1440,6,Friday
2022484408,"2016-05-07 00:00:00",6708,4.71,1269,1995,171,1440,7,Saturday
2022484408,"2016-05-08 00:00:00",3292,2.31,1305,1848,135,1440,1,Sunday
2022484408,"2016-05-09 00:00:00",13379,9.39,1061,2709,379,1440,2,Monday
2022484408,"2016-05-10 00:00:00",12798,8.98,1084,2797,356,1440,3,Tuesday
2022484408,"2016-05-11 00:00:00",13272,9.32,1133,2544,307,1440,4,Wednesday
2022484408,"2016-05-12 00:00:00",9117,6.41,728,1853,268,996,5,Thursday
2026352035,"2016-04-12 00:00:00",4414,2.74,706,1459,192,898,3,Tuesday
2026352035,"2016-04-13 00:00:00",4993,3.1,663,1521,238,901,4,Wednesday
2026352035,"2016-04-14 00:00:00",3335,2.07,653,1431,197,850,5,Thursday
2026352035,"2016-04-15 00:00:00",3821,2.37,687,1444,188,875,6,Friday
2026352035,"2016-04-16 00:00:00",2547,1.58,728,1373,150,878,7,Saturday
2026352035,"2016-04-17 00:00:00",838,0.52,1053,1214,60,1113,1,Sunday
2026352035,"2016-04-18 00:00:00",3325,2.06,1062,1419,182,1244,2,Monday
2026352035,"2016-04-19 00:00:00",2424,1.5,785,1356,141,926,3,Tuesday
2026352035,"2016-04-20 00:00:00",7222,4.48,623,1667,327,950,4,Wednesday
2026352035,"2016-04-21 00:00:00",2467,1.53,749,1370,153,902,5,Thursday
2026352035,"2016-04-22 00:00:00",2915,1.81,712,1399,162,874,6,Friday
2026352035,"2016-04-23 00:00:00",12357,7.71,458,1916,432,890,7,Saturday
2026352035,"2016-04-24 00:00:00",3490,2.16,704,1401,164,868,1,Sunday
2026352035,"2016-04-25 00:00:00",6017,3.73,821,1576,260,1081,2,Monday
2026352035,"2016-04-26 00:00:00",5933,3.68,1018,1595,288,1306,3,Tuesday
2026352035,"2016-04-27 00:00:00",6088,3.77,586,1593,286,872,4,Wednesday
2026352035,"2016-04-28 00:00:00",6375,3.95,626,1649,331,957,5,Thursday
2026352035,"2016-04-29 00:00:00",7604,4.71,492,1692,352,844,6,Friday
2026352035,"2016-04-30 00:00:00",4729,2.93,594,1506,233,827,7,Saturday
2026352035,"2016-05-01 00:00:00",3609,2.28,716,1447,191,907,1,Sunday
2026352035,"2016-05-02 00:00:00",7018,4.35,716,1690,355,1071,2,Monday
2026352035,"2016-05-03 00:00:00",5992,3.72,981,1604,304,1285,3,Tuesday
2026352035,"2016-05-04 00:00:00",6564,4.07,530,1658,345,875,4,Wednesday
2026352035,"2016-05-05 00:00:00",12167,7.54,479,1926,475,954,5,Thursday
2026352035,"2016-05-06 00:00:00",8198,5.08,511,1736,383,894,6,Friday
2026352035,"2016-05-07 00:00:00",4193,2.6,665,1491,229,894,7,Saturday
2026352035,"2016-05-08 00:00:00",5528,3.45,610,1555,258,868,1,Sunday
2026352035,"2016-05-09 00:00:00",10685,6.62,543,1869,401,944,2,Monday
2026352035,"2016-05-10 00:00:00",254,0.16,1002,1141,17,1019,3,Tuesday
2026352035,"2016-05-11 00:00:00",8580,5.32,569,1698,330,899,4,Wednesday
2026352035,"2016-05-12 00:00:00",8891,5.51,330,1364,343,673,5,Thursday
2320127002,"2016-04-12 00:00:00",10725,7.49,1112,2124,328,1440,3,Tuesday
2320127002,"2016-04-13 00:00:00",7275,4.9,1105,2003,335,1440,4,Wednesday
2320127002,"2016-04-14 00:00:00",3973,2.68,1249,1696,191,1440,5,Thursday
2320127002,"2016-04-15 00:00:00",5205,3.51,1195,1801,245,1440,6,Friday
2320127002,"2016-04-16 00:00:00",5057,3.41,1245,1724,195,1440,7,Saturday
2320127002,"2016-04-17 00:00:00",6198,4.18,1191,1852,249,1440,1,Sunday
2320127002,"2016-04-18 00:00:00",6559,4.42,1173,1905,267,1440,2,Monday
2320127002,"2016-04-19 00:00:00",5997,4.04,1201,1811,239,1440,3,Tuesday
2320127002,"2016-04-20 00:00:00",7192,4.85,1146,1922,294,1440,4,Wednesday
2320127002,"2016-04-21 00:00:00",3404,2.29,1302,1610,138,1440,5,Thursday
2320127002,"2016-04-22 00:00:00",5583,3.76,1174,1851,266,1440,6,Friday
2320127002,"2016-04-23 00:00:00",5079,3.42,1129,1804,242,1371,7,Saturday
2320127002,"2016-04-24 00:00:00",4165,2.81,1236,1725,204,1440,1,Sunday
2320127002,"2016-04-25 00:00:00",3588,2.42,1280,1654,160,1440,2,Monday
2320127002,"2016-04-26 00:00:00",3409,2.3,1293,1632,147,1440,3,Tuesday
2320127002,"2016-04-27 00:00:00",1715,1.16,1358,1481,82,1440,4,Wednesday
2320127002,"2016-04-28 00:00:00",1532,1.03,1364,1473,76,1440,5,Thursday
2320127002,"2016-04-29 00:00:00",924,0.62,1395,1410,45,1440,6,Friday
2320127002,"2016-04-30 00:00:00",4571,3.08,1206,1779,234,1440,7,Saturday
2320127002,"2016-05-01 00:00:00",772,0.52,1400,1403,40,1440,1,Sunday
2320127002,"2016-05-02 00:00:00",3634,2.45,1306,1613,134,1440,2,Monday
2320127002,"2016-05-03 00:00:00",7443,5.02,1204,1878,236,1440,3,Tuesday
2320127002,"2016-05-04 00:00:00",1201,0.81,1388,1426,52,1440,4,Wednesday
2320127002,"2016-05-05 00:00:00",5202,3.51,1206,1780,234,1440,5,Thursday
2320127002,"2016-05-06 00:00:00",4878,3.29,1236,1742,204,1440,6,Friday
2320127002,"2016-05-07 00:00:00",7379,4.97,1121,1972,319,1440,7,Saturday
2320127002,"2016-05-08 00:00:00",5161,3.48,1193,1821,247,1440,1,Sunday
2320127002,"2016-05-09 00:00:00",3090,2.08,1295,1630,145,1440,2,Monday
2320127002,"2016-05-10 00:00:00",6227,4.2,1150,1899,290,1440,3,Tuesday
2320127002,"2016-05-11 00:00:00",6424,4.33,1140,1903,300,1440,4,Wednesday
2320127002,"2016-05-12 00:00:00",2661,1.79,830,1125,128,958,5,Thursday
2347167796,"2016-04-12 00:00:00",10113,6.83,964,2344,361,1325,3,Tuesday
2347167796,"2016-04-13 00:00:00",10352,7.01,676,2038,246,922,4,Wednesday
2347167796,"2016-04-14 00:00:00",10129,6.7,705,2010,255,960,5,Thursday
2347167796,"2016-04-15 00:00:00",10465,6.92,720,2133,309,1029,6,Friday
2347167796,"2016-04-16 00:00:00",22244,15.08,968,2670,406,1374,7,Saturday
2347167796,"2016-04-17 00:00:00",5472,3.62,508,1882,257,765,1,Sunday
2347167796,"2016-04-18 00:00:00",8247,5.45,678,1944,233,911,2,Monday
2347167796,"2016-04-19 00:00:00",6711,4.44,648,2346,389,1037,3,Tuesday
2347167796,"2016-04-20 00:00:00",10999,7.27,1011,2198,323,1334,4,Wednesday
2347167796,"2016-04-21 00:00:00",10080,6.75,761,2048,257,1018,5,Thursday
2347167796,"2016-04-22 00:00:00",7804,5.16,781,1946,242,1023,6,Friday
2347167796,"2016-04-23 00:00:00",16901,11.37,591,2629,427,1018,7,Saturday
2347167796,"2016-04-24 00:00:00",9471,6.26,584,2187,360,944,1,Sunday
2347167796,"2016-04-25 00:00:00",9482,6.38,653,2095,303,956,2,Monday
2347167796,"2016-04-26 00:00:00",5980,3.95,732,1861,227,959,3,Tuesday
2347167796,"2016-04-27 00:00:00",11423,7.58,623,2194,330,953,4,Wednesday
2347167796,"2016-04-28 00:00:00",5439,3.6,764,1854,229,993,5,Thursday
2347167796,"2016-04-29 00:00:00",42,0.03,2,403,4,6,6,Friday
2873212765,"2016-04-12 00:00:00",8796,5.91,1061,1982,379,1440,3,Tuesday
2873212765,"2016-04-13 00:00:00",7618,5.12,1028,2004,412,1440,4,Wednesday
2873212765,"2016-04-14 00:00:00",7910,5.32,1109,1893,331,1440,5,Thursday
2873212765,"2016-04-15 00:00:00",8482,5.7,992,2063,448,1440,6,Friday
2873212765,"2016-04-16 00:00:00",9685,6.65,1087,2148,353,1440,7,Saturday
2873212765,"2016-04-17 00:00:00",2524,1.7,1272,1529,168,1440,1,Sunday
2873212765,"2016-04-18 00:00:00",7762,5.24,1122,1890,318,1440,2,Monday
2873212765,"2016-04-19 00:00:00",7948,5.37,1051,1956,389,1440,3,Tuesday
2873212765,"2016-04-20 00:00:00",9202,6.3,1035,2094,405,1440,4,Wednesday
2873212765,"2016-04-21 00:00:00",8859,5.98,1057,1970,383,1440,5,Thursday
2873212765,"2016-04-22 00:00:00",7286,4.9,1028,2241,412,1440,6,Friday
2873212765,"2016-04-23 00:00:00",9317,6.35,1077,2021,363,1440,7,Saturday
2873212765,"2016-04-24 00:00:00",6873,4.68,1203,1898,237,1440,1,Sunday
2873212765,"2016-04-25 00:00:00",7373,4.95,1081,1907,359,1440,2,Monday
2873212765,"2016-04-26 00:00:00",8242,5.54,1124,1882,316,1440,3,Tuesday
2873212765,"2016-04-27 00:00:00",3516,2.36,1197,1966,243,1440,4,Wednesday
2873212765,"2016-04-28 00:00:00",7913,5.41,1192,1835,248,1440,5,Thursday
2873212765,"2016-04-29 00:00:00",7365,4.95,1191,1780,249,1440,6,Friday
2873212765,"2016-04-30 00:00:00",8452,5.68,1167,1830,273,1440,7,Saturday
2873212765,"2016-05-01 00:00:00",7399,4.97,1219,1739,221,1440,1,Sunday
2873212765,"2016-05-02 00:00:00",7525,5.06,1099,1878,341,1440,2,Monday
2873212765,"2016-05-03 00:00:00",7412,4.98,1070,1906,370,1440,3,Tuesday
2873212765,"2016-05-04 00:00:00",8278,5.56,1020,2015,420,1440,4,Wednesday
2873212765,"2016-05-05 00:00:00",8314,5.61,1093,1971,347,1440,5,Thursday
2873212765,"2016-05-06 00:00:00",7063,4.75,1065,1910,375,1440,6,Friday
2873212765,"2016-05-07 00:00:00",4940,3.38,1302,1897,138,1440,7,Saturday
2873212765,"2016-05-08 00:00:00",8168,5.54,1068,2096,372,1440,1,Sunday
2873212765,"2016-05-09 00:00:00",7726,5.19,1095,1906,345,1440,2,Monday
2873212765,"2016-05-10 00:00:00",8275,5.56,1067,1962,373,1440,3,Tuesday
2873212765,"2016-05-11 00:00:00",6440,4.33,1121,1826,319,1440,4,Wednesday
2873212765,"2016-05-12 00:00:00",7566,5.11,720,1431,268,988,5,Thursday
3372868164,"2016-04-12 00:00:00",4747,3.24,1160,1788,280,1440,3,Tuesday
3372868164,"2016-04-13 00:00:00",9715,6.63,1045,2093,395,1440,4,Wednesday
3372868164,"2016-04-14 00:00:00",8844,6.03,1039,2065,401,1440,5,Thursday
3372868164,"2016-04-15 00:00:00",7451,5.08,1105,1908,335,1440,6,Friday
3372868164,"2016-04-16 00:00:00",6905,4.73,1084,1908,356,1440,7,Saturday
3372868164,"2016-04-17 00:00:00",8199,5.88,1105,1964,335,1440,1,Sunday
3372868164,"2016-04-18 00:00:00",6798,4.64,1070,2014,370,1440,2,Monday
3372868164,"2016-04-19 00:00:00",7711,5.26,1064,1985,376,1440,3,Tuesday
3372868164,"2016-04-20 00:00:00",4880,3.33,1148,1867,292,1440,4,Wednesday
3372868164,"2016-04-21 00:00:00",8857,6.07,1037,2124,403,1440,5,Thursday
3372868164,"2016-04-22 00:00:00",3843,2.62,1234,1669,206,1440,6,Friday
3372868164,"2016-04-23 00:00:00",7396,5.07,1115,1995,325,1440,7,Saturday
3372868164,"2016-04-24 00:00:00",6731,4.59,1127,1921,313,1440,1,Sunday
3372868164,"2016-04-25 00:00:00",5995,4.09,1024,2010,416,1440,2,Monday
3372868164,"2016-04-26 00:00:00",8283,5.79,1083,2057,357,1440,3,Tuesday
3372868164,"2016-04-27 00:00:00",7904,5.42,1057,2095,383,1440,4,Wednesday
3372868164,"2016-04-28 00:00:00",5512,3.76,1055,1972,385,1440,5,Thursday
3372868164,"2016-04-29 00:00:00",9135,6.23,1038,2044,402,1440,6,Friday
3372868164,"2016-04-30 00:00:00",5250,3.58,1119,1946,321,1440,7,Saturday
3372868164,"2016-05-01 00:00:00",3077,2.1,842,1237,172,1014,1,Sunday
3977333714,"2016-04-12 00:00:00",8856,5.98,777,1450,194,971,3,Tuesday
3977333714,"2016-04-13 00:00:00",10035,6.71,754,1495,230,984,4,Wednesday
3977333714,"2016-04-14 00:00:00",7641,5.11,801,1433,242,1043,5,Thursday
3977333714,"2016-04-15 00:00:00",9010,6.06,644,1468,240,884,6,Friday
3977333714,"2016-04-16 00:00:00",13459,9,663,1625,267,930,7,Saturday
3977333714,"2016-04-17 00:00:00",10415,6.97,600,1529,274,874,1,Sunday
3977333714,"2016-04-18 00:00:00",11663,7.8,605,1584,313,918,2,Monday
3977333714,"2016-04-19 00:00:00",12414,8.78,738,1638,307,1045,3,Tuesday
3977333714,"2016-04-20 00:00:00",11658,7.83,845,1554,264,1109,4,Wednesday
3977333714,"2016-04-21 00:00:00",6093,4.08,712,1397,242,954,5,Thursday
3977333714,"2016-04-22 00:00:00",8911,5.96,731,1481,233,964,6,Friday
3977333714,"2016-04-23 00:00:00",12058,8.07,724,1638,344,1068,7,Saturday
3977333714,"2016-04-24 00:00:00",14112,10,660,1655,254,914,1,Sunday
3977333714,"2016-04-25 00:00:00",11177,8.48,781,1570,192,973,2,Monday
3977333714,"2016-04-26 00:00:00",11388,7.62,797,1551,272,1069,3,Tuesday
3977333714,"2016-04-27 00:00:00",7193,5.04,714,1377,186,900,4,Wednesday
3977333714,"2016-04-28 00:00:00",7114,4.88,804,1407,213,1017,5,Thursday
3977333714,"2016-04-29 00:00:00",10645,7.75,744,1545,218,962,6,Friday
3977333714,"2016-04-30 00:00:00",13238,9.2,687,1650,289,976,7,Saturday
3977333714,"2016-05-01 00:00:00",10414,7.07,691,1501,205,896,1,Sunday
3977333714,"2016-05-02 00:00:00",16520,11.05,713,1760,343,1056,2,Monday
3977333714,"2016-05-03 00:00:00",14335,9.59,594,1710,346,940,3,Tuesday
3977333714,"2016-05-04 00:00:00",13559,9.44,852,1628,252,1104,4,Wednesday
3977333714,"2016-05-05 00:00:00",12312,8.58,680,1618,280,960,5,Thursday
3977333714,"2016-05-06 00:00:00",11677,8.28,676,1590,252,928,6,Friday
3977333714,"2016-05-07 00:00:00",11550,7.73,703,1574,294,997,7,Saturday
3977333714,"2016-05-08 00:00:00",13585,9.09,688,1633,296,984,1,Sunday
3977333714,"2016-05-09 00:00:00",14687,10.08,1159,1667,281,1440,2,Monday
3977333714,"2016-05-10 00:00:00",13072,8.78,676,1630,312,988,3,Tuesday
3977333714,"2016-05-11 00:00:00",746,0.5,13,52,13,26,4,Wednesday
4020332650,"2016-04-12 00:00:00",8539,6.12,712,3654,350,1062,3,Tuesday
4020332650,"2016-04-13 00:00:00",0,0,1440,1981,0,1440,4,Wednesday
4020332650,"2016-04-14 00:00:00",108,0.08,1437,2011,3,1440,5,Thursday
4020332650,"2016-04-15 00:00:00",1882,1.35,1299,2951,141,1440,6,Friday
4020332650,"2016-04-16 00:00:00",1982,1.42,1222,3051,141,1363,7,Saturday
4020332650,"2016-04-17 00:00:00",16,0.01,1438,1990,2,1440,1,Sunday
4020332650,"2016-04-18 00:00:00",62,0.04,1438,1995,2,1440,2,Monday
4020332650,"2016-04-19 00:00:00",0,0,1440,1980,0,1440,3,Tuesday
4020332650,"2016-04-20 00:00:00",0,0,1440,1980,0,1440,4,Wednesday
4020332650,"2016-04-21 00:00:00",0,0,1440,1980,0,1440,5,Thursday
4020332650,"2016-04-22 00:00:00",0,0,1440,1980,0,1440,6,Friday
4020332650,"2016-04-23 00:00:00",0,0,1440,1980,0,1440,7,Saturday
4020332650,"2016-04-24 00:00:00",0,0,1440,1980,0,1440,1,Sunday
4020332650,"2016-04-25 00:00:00",0,0,1440,1980,0,1440,2,Monday
4020332650,"2016-04-26 00:00:00",0,0,1440,1980,0,1440,3,Tuesday
4020332650,"2016-04-27 00:00:00",0,0,1440,1980,0,1440,4,Wednesday
4020332650,"2016-04-28 00:00:00",0,0,1440,1980,0,1440,5,Thursday
4020332650,"2016-04-29 00:00:00",0,0,1440,1980,0,1440,6,Friday
4020332650,"2016-04-30 00:00:00",0,0,1440,1980,0,1440,7,Saturday
4020332650,"2016-05-01 00:00:00",0,0,1440,1980,0,1440,1,Sunday
4020332650,"2016-05-02 00:00:00",475,0.34,1350,2207,42,1392,2,Monday
4020332650,"2016-05-03 00:00:00",4496,3.22,950,2828,174,1124,3,Tuesday
4020332650,"2016-05-04 00:00:00",10252,7.35,531,3879,405,936,4,Wednesday
4020332650,"2016-05-05 00:00:00",11728,8.43,916,3429,276,1192,5,Thursday
4020332650,"2016-05-06 00:00:00",4369,3.13,855,2704,177,1032,6,Friday
4020332650,"2016-05-07 00:00:00",6132,4.4,1256,2975,184,1440,7,Saturday
4020332650,"2016-05-08 00:00:00",5862,4.2,775,3089,263,1038,1,Sunday
4020332650,"2016-05-09 00:00:00",4556,3.27,1225,2785,181,1406,2,Monday
4020332650,"2016-05-10 00:00:00",5546,3.98,774,2926,206,980,3,Tuesday
4020332650,"2016-05-11 00:00:00",3689,2.65,1296,2645,144,1440,4,Wednesday
4020332650,"2016-05-12 00:00:00",590,0.42,721,1120,21,742,5,Thursday
4057192912,"2016-04-12 00:00:00",5394,4.03,1276,2286,164,1440,3,Tuesday
4057192912,"2016-04-13 00:00:00",5974,4.47,1280,2306,160,1440,4,Wednesday
4057192912,"2016-04-14 00:00:00",0,0,1440,1776,0,1440,5,Thursday
4057192912,"2016-04-15 00:00:00",3984,2.95,873,1527,97,970,6,Friday
4319703577,"2016-04-12 00:00:00",7753,5.2,1440,2115,0,1440,3,Tuesday
4319703577,"2016-04-13 00:00:00",8204,5.5,1234,2135,119,1353,4,Wednesday
4319703577,"2016-04-14 00:00:00",10210,6.88,589,2302,349,938,5,Thursday
4319703577,"2016-04-15 00:00:00",5664,3.8,752,1985,228,980,6,Friday
4319703577,"2016-04-16 00:00:00",4744,3.18,724,1884,194,918,7,Saturday
4319703577,"2016-04-17 00:00:00",29,0.02,1363,1464,3,1366,1,Sunday
4319703577,"2016-04-18 00:00:00",2276,1.55,824,1632,68,892,2,Monday
4319703577,"2016-04-19 00:00:00",8925,5.99,604,2200,311,915,3,Tuesday
4319703577,"2016-04-20 00:00:00",8954,6.01,671,2220,324,995,4,Wednesday
4319703577,"2016-04-21 00:00:00",3702,2.48,1265,1792,34,1299,5,Thursday
4319703577,"2016-04-22 00:00:00",4500,3.02,709,1886,196,905,6,Friday
4319703577,"2016-04-23 00:00:00",4935,3.31,546,1945,233,779,7,Saturday
4319703577,"2016-04-24 00:00:00",4081,2.74,692,1880,197,889,1,Sunday
4319703577,"2016-04-25 00:00:00",9259,6.21,544,2314,398,942,2,Monday
4319703577,"2016-04-26 00:00:00",9899,6.64,649,2236,317,966,3,Tuesday
4319703577,"2016-04-27 00:00:00",10780,7.23,680,2324,353,1033,4,Wednesday
4319703577,"2016-04-28 00:00:00",10817,7.28,552,2367,380,932,5,Thursday
4319703577,"2016-04-29 00:00:00",7990,5.36,624,2175,313,937,6,Friday
4319703577,"2016-04-30 00:00:00",8221,5.52,695,2092,240,935,7,Saturday
4319703577,"2016-05-01 00:00:00",1251,0.84,836,1593,67,903,1,Sunday
4319703577,"2016-05-02 00:00:00",9261,6.24,585,2270,355,940,2,Monday
4319703577,"2016-05-03 00:00:00",9648,6.47,669,2235,321,990,3,Tuesday
4319703577,"2016-05-04 00:00:00",10429,7.02,1106,2282,334,1440,4,Wednesday
4319703577,"2016-05-05 00:00:00",13658,9.49,957,2530,389,1346,5,Thursday
4319703577,"2016-05-06 00:00:00",9524,6.42,692,2266,331,1023,6,Friday
4319703577,"2016-05-07 00:00:00",7937,5.33,586,2158,310,896,7,Saturday
4319703577,"2016-05-08 00:00:00",3672,2.46,603,1792,153,756,1,Sunday
4319703577,"2016-05-09 00:00:00",10378,6.96,490,2345,390,880,2,Monday
4319703577,"2016-05-10 00:00:00",9487,6.37,555,2260,344,899,3,Tuesday
4319703577,"2016-05-11 00:00:00",9129,6.13,574,2232,332,906,4,Wednesday
4319703577,"2016-05-12 00:00:00",17,0.01,0,257,2,2,5,Thursday
4388161847,"2016-04-12 00:00:00",10122,7.78,1440,2955,0,1440,3,Tuesday
4388161847,"2016-04-13 00:00:00",10993,8.45,1275,3092,165,1440,4,Wednesday
4388161847,"2016-04-14 00:00:00",8863,6.82,945,2998,264,1209,5,Thursday
4388161847,"2016-04-15 00:00:00",8758,6.73,837,3066,299,1136,6,Friday
4388161847,"2016-04-16 00:00:00",6580,5.06,609,3073,268,877,7,Saturday
4388161847,"2016-04-17 00:00:00",4660,3.58,721,2572,201,922,1,Sunday
4388161847,"2016-04-18 00:00:00",11009,9.1,1017,3274,274,1291,2,Monday
4388161847,"2016-04-19 00:00:00",10181,7.83,704,3015,285,989,3,Tuesday
4388161847,"2016-04-20 00:00:00",10553,8.12,696,3083,289,985,4,Wednesday
4388161847,"2016-04-21 00:00:00",10055,7.73,853,3069,291,1144,5,Thursday
4388161847,"2016-04-22 00:00:00",12139,9.34,945,3544,322,1267,6,Friday
4388161847,"2016-04-23 00:00:00",13236,10.18,749,3306,278,1027,7,Saturday
4388161847,"2016-04-24 00:00:00",10243,7.88,584,2885,261,845,1,Sunday
4388161847,"2016-04-25 00:00:00",12961,9.97,1054,3288,343,1397,2,Monday
4388161847,"2016-04-26 00:00:00",9461,7.28,673,2929,261,934,3,Tuesday
4388161847,"2016-04-27 00:00:00",11193,8.61,684,3074,300,984,4,Wednesday
4388161847,"2016-04-28 00:00:00",10074,7.75,878,2969,262,1140,5,Thursday
4388161847,"2016-04-29 00:00:00",9232,7.1,1175,2979,265,1440,6,Friday
4388161847,"2016-04-30 00:00:00",12533,9.64,537,3283,357,894,7,Saturday
4388161847,"2016-05-01 00:00:00",10255,7.89,579,2926,268,847,1,Sunday
4388161847,"2016-05-02 00:00:00",10096,8.4,935,3147,241,1176,2,Monday
4388161847,"2016-05-03 00:00:00",12727,9.79,984,3290,342,1326,3,Tuesday
4388161847,"2016-05-04 00:00:00",12375,9.52,632,3162,307,939,4,Wednesday
4388161847,"2016-05-05 00:00:00",9603,7.38,896,2899,250,1146,5,Thursday
4388161847,"2016-05-06 00:00:00",13175,10.13,1100,3425,340,1440,6,Friday
4388161847,"2016-05-07 00:00:00",22770,17.54,508,4022,436,944,7,Saturday
4388161847,"2016-05-08 00:00:00",17298,14.38,576,3934,323,899,1,Sunday
4388161847,"2016-05-09 00:00:00",10218,7.86,1020,3013,283,1303,2,Monday
4388161847,"2016-05-10 00:00:00",10299,7.92,648,3061,294,942,3,Tuesday
4388161847,"2016-05-11 00:00:00",10201,7.84,858,2954,282,1140,4,Wednesday
4388161847,"2016-05-12 00:00:00",3369,2.59,825,1623,108,933,5,Thursday
4445114986,"2016-04-12 00:00:00",3276,2.2,787,2113,196,983,3,Tuesday
4445114986,"2016-04-13 00:00:00",2961,1.99,840,2095,194,1034,4,Wednesday
4445114986,"2016-04-14 00:00:00",3974,2.67,717,2194,231,948,5,Thursday
4445114986,"2016-04-15 00:00:00",7198,4.83,711,2496,350,1061,6,Friday
4445114986,"2016-04-16 00:00:00",3945,2.65,716,2180,225,941,7,Saturday
4445114986,"2016-04-17 00:00:00",2268,1.52,1219,1933,114,1333,1,Sunday
4445114986,"2016-04-18 00:00:00",6155,4.24,1247,2248,193,1440,2,Monday
4445114986,"2016-04-19 00:00:00",2064,1.39,895,1954,121,1016,3,Tuesday
4445114986,"2016-04-20 00:00:00",2072,1.39,841,1974,137,978,4,Wednesday
4445114986,"2016-04-21 00:00:00",3809,2.56,756,2150,215,971,5,Thursday
4445114986,"2016-04-22 00:00:00",6831,4.58,706,2432,317,1023,6,Friday
4445114986,"2016-04-23 00:00:00",4363,2.93,1239,2149,201,1440,7,Saturday
4445114986,"2016-04-24 00:00:00",5002,3.36,1196,2247,244,1440,1,Sunday
4445114986,"2016-04-25 00:00:00",3385,2.27,916,2070,179,1095,2,Monday
4445114986,"2016-04-26 00:00:00",6326,4.41,839,2291,210,1049,3,Tuesday
4445114986,"2016-04-27 00:00:00",7243,5.03,839,2361,227,1066,4,Wednesday
4445114986,"2016-04-28 00:00:00",4493,3.01,762,2203,236,998,5,Thursday
4445114986,"2016-04-29 00:00:00",4676,3.14,1106,2196,226,1332,6,Friday
4445114986,"2016-04-30 00:00:00",6222,4.18,797,2363,290,1087,7,Saturday
4445114986,"2016-05-01 00:00:00",5232,3.51,741,2246,240,981,1,Sunday
4445114986,"2016-05-02 00:00:00",6910,4.75,667,2336,231,898,2,Monday
4445114986,"2016-05-03 00:00:00",7502,5.18,725,2421,265,990,3,Tuesday
4445114986,"2016-05-04 00:00:00",2923,1.96,897,2070,180,1077,4,Wednesday
4445114986,"2016-05-05 00:00:00",3800,2.55,734,2120,193,927,5,Thursday
4445114986,"2016-05-06 00:00:00",4514,3.03,809,2211,229,1038,6,Friday
4445114986,"2016-05-07 00:00:00",5183,3.59,866,2123,138,1004,7,Saturday
4445114986,"2016-05-08 00:00:00",7303,4.9,733,2423,316,1049,1,Sunday
4445114986,"2016-05-09 00:00:00",5275,3.54,641,2281,266,907,2,Monday
4445114986,"2016-05-10 00:00:00",3915,2.63,783,2181,231,1014,3,Tuesday
4445114986,"2016-05-11 00:00:00",9105,6.11,622,2499,288,910,4,Wednesday
4445114986,"2016-05-12 00:00:00",768,0.52,380,1212,58,438,5,Thursday
4558609924,"2016-04-12 00:00:00",5135,3.39,1122,1909,318,1440,3,Tuesday
4558609924,"2016-04-13 00:00:00",4978,3.29,1287,1722,153,1440,4,Wednesday
4558609924,"2016-04-14 00:00:00",6799,4.49,1161,1922,279,1440,5,Thursday
4558609924,"2016-04-15 00:00:00",7795,5.15,1131,2121,309,1440,6,Friday
4558609924,"2016-04-16 00:00:00",7289,4.82,1112,1997,328,1440,7,Saturday
4558609924,"2016-04-17 00:00:00",9634,6.4,1110,2117,330,1440,1,Sunday
4558609924,"2016-04-18 00:00:00",8940,5.91,1080,2116,360,1440,2,Monday
4558609924,"2016-04-19 00:00:00",5401,3.57,1182,1876,258,1440,3,Tuesday
4558609924,"2016-04-20 00:00:00",4803,3.17,1218,1788,222,1440,4,Wednesday
4558609924,"2016-04-21 00:00:00",13743,9.08,844,2486,459,1303,5,Thursday
4558609924,"2016-04-22 00:00:00",9601,6.35,1122,2094,318,1440,6,Friday
4558609924,"2016-04-23 00:00:00",6890,4.55,1122,2085,318,1440,7,Saturday
4558609924,"2016-04-24 00:00:00",8563,5.66,1045,2173,395,1440,1,Sunday
4558609924,"2016-04-25 00:00:00",8095,5.35,993,2225,368,1361,2,Monday
4558609924,"2016-04-26 00:00:00",9148,6.05,1062,2223,336,1398,3,Tuesday
4558609924,"2016-04-27 00:00:00",9557,6.32,1087,2098,353,1440,4,Wednesday
4558609924,"2016-04-28 00:00:00",9451,6.25,985,2185,379,1364,5,Thursday
4558609924,"2016-04-29 00:00:00",7833,5.18,1096,1918,241,1337,6,Friday
4558609924,"2016-04-30 00:00:00",10319,6.82,1111,2105,329,1440,7,Saturday
4558609924,"2016-05-01 00:00:00",3428,2.27,1121,1692,190,1311,1,Sunday
4558609924,"2016-05-02 00:00:00",7891,5.22,1057,2066,383,1440,2,Monday
4558609924,"2016-05-03 00:00:00",5267,3.48,1172,1953,268,1440,3,Tuesday
4558609924,"2016-05-04 00:00:00",5232,3.46,1188,1842,252,1440,4,Wednesday
4558609924,"2016-05-05 00:00:00",10611,7.01,1048,2262,392,1440,5,Thursday
4558609924,"2016-05-06 00:00:00",3755,2.48,1238,1722,202,1440,6,Friday
4558609924,"2016-05-07 00:00:00",8237,5.44,1116,1973,272,1388,7,Saturday
4558609924,"2016-05-08 00:00:00",6543,4.33,1019,2666,339,1358,1,Sunday
4558609924,"2016-05-09 00:00:00",11451,7.57,1065,2223,375,1440,2,Monday
4558609924,"2016-05-10 00:00:00",6435,4.25,1191,1889,249,1440,3,Tuesday
4558609924,"2016-05-11 00:00:00",9108,6.02,1081,2131,359,1440,4,Wednesday
4558609924,"2016-05-12 00:00:00",6307,4.17,736,1452,247,983,5,Thursday
4702921684,"2016-04-12 00:00:00",7213,5.88,718,2947,263,981,3,Tuesday
4702921684,"2016-04-13 00:00:00",6877,5.58,777,2898,258,1035,4,Wednesday
4702921684,"2016-04-14 00:00:00",7860,6.37,772,2984,271,1043,5,Thursday
4702921684,"2016-04-15 00:00:00",6506,5.28,944,2896,265,1209,6,Friday
4702921684,"2016-04-16 00:00:00",11140,9.03,556,3328,362,918,7,Saturday
4702921684,"2016-04-17 00:00:00",12692,10.29,437,3394,380,817,1,Sunday
4702921684,"2016-04-18 00:00:00",9105,7.38,890,3013,243,1133,2,Monday
4702921684,"2016-04-19 00:00:00",6708,5.44,757,2812,197,954,3,Tuesday
4702921684,"2016-04-20 00:00:00",8793,7.13,717,3061,291,1008,4,Wednesday
4702921684,"2016-04-21 00:00:00",6530,5.3,901,2729,189,1090,5,Thursday
4702921684,"2016-04-22 00:00:00",1664,1.35,1341,2241,72,1413,6,Friday
4702921684,"2016-04-23 00:00:00",15126,12.27,469,3691,483,952,7,Saturday
4702921684,"2016-04-24 00:00:00",15050,12.22,542,3538,391,933,1,Sunday
4702921684,"2016-04-25 00:00:00",9167,7.43,730,3064,291,1021,2,Monday
4702921684,"2016-04-26 00:00:00",6108,4.95,765,2784,225,990,3,Tuesday
4702921684,"2016-04-27 00:00:00",7047,5.72,733,2908,255,988,4,Wednesday
4702921684,"2016-04-28 00:00:00",9023,7.32,738,3033,255,993,5,Thursday
4702921684,"2016-04-29 00:00:00",9930,8.05,692,3165,298,990,6,Friday
4702921684,"2016-04-30 00:00:00",10144,8.23,728,3115,303,1031,7,Saturday
4702921684,"2016-05-01 00:00:00",0,0,1440,2017,0,1440,1,Sunday
4702921684,"2016-05-02 00:00:00",7245,5.92,1131,2859,240,1371,2,Monday
4702921684,"2016-05-03 00:00:00",9454,7.67,729,3145,313,1042,3,Tuesday
4702921684,"2016-05-04 00:00:00",8161,6.62,757,3004,270,1027,4,Wednesday
4702921684,"2016-05-05 00:00:00",8614,6.99,745,3006,254,999,5,Thursday
4702921684,"2016-05-06 00:00:00",6943,5.63,682,2859,224,906,6,Friday
4702921684,"2016-05-07 00:00:00",14370,11.65,577,3683,490,1067,7,Saturday
4702921684,"2016-05-08 00:00:00",12857,10.43,1019,3287,326,1345,1,Sunday
4702921684,"2016-05-09 00:00:00",8232,6.68,746,2990,265,1011,2,Monday
4702921684,"2016-05-10 00:00:00",10613,8.61,701,3172,300,1001,3,Tuesday
4702921684,"2016-05-11 00:00:00",9810,7.96,784,3069,286,1070,4,Wednesday
4702921684,"2016-05-12 00:00:00",2752,2.23,241,1240,68,309,5,Thursday
5553957443,"2016-04-12 00:00:00",11596,7.57,767,2026,309,1076,3,Tuesday
5553957443,"2016-04-13 00:00:00",4832,3.16,647,1718,226,873,4,Wednesday
5553957443,"2016-04-14 00:00:00",17022,11.12,693,2324,358,1051,5,Thursday
5553957443,"2016-04-15 00:00:00",16556,10.86,689,2254,335,1024,6,Friday
5553957443,"2016-04-16 00:00:00",5771,3.77,521,1831,288,809,7,Saturday
5553957443,"2016-04-17 00:00:00",655,0.43,943,1397,46,989,1,Sunday
5553957443,"2016-04-18 00:00:00",3727,2.43,622,1683,206,828,2,Monday
5553957443,"2016-04-19 00:00:00",15482,10.11,756,2284,346,1102,3,Tuesday
5553957443,"2016-04-20 00:00:00",2713,1.77,598,1570,148,746,4,Wednesday
5553957443,"2016-04-21 00:00:00",12346,8.06,801,2066,266,1067,5,Thursday
5553957443,"2016-04-22 00:00:00",11682,7.63,781,2105,311,1092,6,Friday
5553957443,"2016-04-23 00:00:00",4112,2.69,443,1776,272,715,7,Saturday
5553957443,"2016-04-24 00:00:00",1807,1.18,582,1507,104,686,1,Sunday
5553957443,"2016-04-25 00:00:00",10946,7.19,732,2033,263,995,2,Monday
5553957443,"2016-04-26 00:00:00",11886,7.76,750,2093,296,1046,3,Tuesday
5553957443,"2016-04-27 00:00:00",10538,6.88,745,1922,238,983,4,Wednesday
5553957443,"2016-04-28 00:00:00",11393,7.63,727,1999,227,954,5,Thursday
5553957443,"2016-04-29 00:00:00",12764,8.33,709,2169,331,1040,6,Friday
5553957443,"2016-04-30 00:00:00",1202,0.78,506,1463,84,590,7,Saturday
5553957443,"2016-05-01 00:00:00",5164,3.37,436,1747,237,673,1,Sunday
5553957443,"2016-05-02 00:00:00",9769,6.38,724,1996,259,983,2,Monday
5553957443,"2016-05-03 00:00:00",12848,8.39,812,2116,302,1114,3,Tuesday
5553957443,"2016-05-04 00:00:00",4249,2.77,651,1698,224,875,4,Wednesday
5553957443,"2016-05-05 00:00:00",14331,9.51,692,2156,314,1006,5,Thursday
5553957443,"2016-05-06 00:00:00",9632,6.29,761,1916,259,1020,6,Friday
5553957443,"2016-05-07 00:00:00",1868,1.22,902,1494,96,998,7,Saturday
5553957443,"2016-05-08 00:00:00",6083,4,505,1762,221,726,1,Sunday
5553957443,"2016-05-09 00:00:00",11611,7.58,667,2272,332,999,2,Monday
5553957443,"2016-05-10 00:00:00",16358,10.71,707,2335,366,1073,3,Tuesday
5553957443,"2016-05-11 00:00:00",4926,3.22,628,1693,195,823,4,Wednesday
5553957443,"2016-05-12 00:00:00",3121,2.04,222,741,62,284,5,Thursday
5577150313,"2016-04-12 00:00:00",8135,6.08,728,3405,242,970,3,Tuesday
5577150313,"2016-04-13 00:00:00",5077,3.79,776,2551,170,946,4,Wednesday
5577150313,"2016-04-14 00:00:00",8596,6.42,662,4022,324,986,5,Thursday
5577150313,"2016-04-15 00:00:00",12087,9.08,695,4005,368,1063,6,Friday
5577150313,"2016-04-16 00:00:00",14269,10.66,472,4274,398,870,7,Saturday
5577150313,"2016-04-17 00:00:00",12231,9.14,525,4552,396,921,1,Sunday
5577150313,"2016-04-18 00:00:00",9893,7.39,623,3625,276,899,2,Monday
5577150313,"2016-04-19 00:00:00",12574,9.42,733,3501,242,975,3,Tuesday
5577150313,"2016-04-20 00:00:00",8330,6.22,773,3192,216,989,4,Wednesday
5577150313,"2016-04-21 00:00:00",10830,8.09,670,4018,359,1029,5,Thursday
5577150313,"2016-04-22 00:00:00",9172,6.85,823,3329,292,1115,6,Friday
5577150313,"2016-04-23 00:00:00",7638,5.71,627,3152,271,898,7,Saturday
5577150313,"2016-04-24 00:00:00",15764,11.78,425,4392,416,841,1,Sunday
5577150313,"2016-04-25 00:00:00",6393,4.78,743,3374,313,1056,2,Monday
5577150313,"2016-04-26 00:00:00",5325,3.98,759,3088,251,1010,3,Tuesday
5577150313,"2016-04-27 00:00:00",6805,5.14,773,3294,269,1042,4,Wednesday
5577150313,"2016-04-28 00:00:00",9841,7.43,692,3580,291,983,5,Thursday
5577150313,"2016-04-29 00:00:00",7924,5.92,739,3544,298,1037,6,Friday
5577150313,"2016-04-30 00:00:00",12363,9.24,621,4501,415,1036,7,Saturday
5577150313,"2016-05-01 00:00:00",13368,9.99,499,4546,444,943,1,Sunday
5577150313,"2016-05-02 00:00:00",7439,5.56,732,3014,292,1024,2,Monday
5577150313,"2016-05-03 00:00:00",11045,8.25,580,3795,317,897,3,Tuesday
5577150313,"2016-05-04 00:00:00",5206,3.89,631,2755,175,806,4,Wednesday
5577150313,"2016-05-05 00:00:00",7550,5.64,1153,3004,209,1362,5,Thursday
5577150313,"2016-05-06 00:00:00",4950,3.7,1304,2643,136,1440,6,Friday
5577150313,"2016-05-07 00:00:00",0,0,1440,1819,0,1440,7,Saturday
5577150313,"2016-05-08 00:00:00",0,0,1440,1819,0,1440,1,Sunday
5577150313,"2016-05-09 00:00:00",3421,2.56,1099,2489,115,1214,2,Monday
5577150313,"2016-05-10 00:00:00",8869,6.65,639,3841,335,974,3,Tuesday
5577150313,"2016-05-11 00:00:00",4038,3.04,257,1665,123,380,4,Wednesday
6117666160,"2016-04-12 00:00:00",0,0,1440,1496,0,1440,3,Tuesday
6117666160,"2016-04-13 00:00:00",0,0,1440,1496,0,1440,4,Wednesday
6117666160,"2016-04-14 00:00:00",0,0,1440,1496,0,1440,5,Thursday
6117666160,"2016-04-15 00:00:00",14019,10.59,921,2865,519,1440,6,Friday
6117666160,"2016-04-16 00:00:00",14450,10.91,502,2828,540,1042,7,Saturday
6117666160,"2016-04-17 00:00:00",7150,5.4,702,2225,312,1014,1,Sunday
6117666160,"2016-04-18 00:00:00",5153,3.91,759,2018,241,1000,2,Monday
6117666160,"2016-04-19 00:00:00",11135,8.41,425,2606,480,905,3,Tuesday
6117666160,"2016-04-20 00:00:00",10449,8.02,587,2536,385,972,4,Wednesday
6117666160,"2016-04-21 00:00:00",19542,15.01,579,4900,324,903,5,Thursday
6117666160,"2016-04-22 00:00:00",8206,6.2,413,2409,402,815,6,Friday
6117666160,"2016-04-23 00:00:00",11495,8.68,468,2651,512,980,7,Saturday
6117666160,"2016-04-24 00:00:00",7623,5.76,711,2305,362,1073,1,Sunday
6117666160,"2016-04-25 00:00:00",0,0,1440,1497,0,1440,2,Monday
6117666160,"2016-04-26 00:00:00",9543,7.21,1077,2450,359,1436,3,Tuesday
6117666160,"2016-04-27 00:00:00",9411,7.11,417,2576,458,875,4,Wednesday
6117666160,"2016-04-28 00:00:00",3403,2.6,758,1879,141,899,5,Thursday
6117666160,"2016-04-29 00:00:00",9592,7.24,479,2560,461,940,6,Friday
6117666160,"2016-04-30 00:00:00",6987,5.28,1040,2275,343,1383,7,Saturday
6117666160,"2016-05-01 00:00:00",8915,6.73,525,2361,397,922,1,Sunday
6117666160,"2016-05-02 00:00:00",4933,3.73,1204,2044,236,1440,2,Monday
6117666160,"2016-05-03 00:00:00",0,0,1440,1496,0,1440,3,Tuesday
6117666160,"2016-05-04 00:00:00",2997,2.26,1279,1902,156,1435,4,Wednesday
6117666160,"2016-05-05 00:00:00",9799,7.4,479,2636,487,966,5,Thursday
6117666160,"2016-05-06 00:00:00",3365,2.68,673,1838,133,806,6,Friday
6117666160,"2016-05-07 00:00:00",7336,5.54,456,2469,412,868,7,Saturday
6117666160,"2016-05-08 00:00:00",7328,5.53,517,2250,318,835,1,Sunday
6117666160,"2016-05-09 00:00:00",4477,3.38,125,1248,197,322,2,Monday
6290855005,"2016-04-12 00:00:00",4562,3.45,1241,2560,199,1440,3,Tuesday
6290855005,"2016-04-13 00:00:00",7142,5.4,1090,2905,350,1440,4,Wednesday
6290855005,"2016-04-14 00:00:00",7671,5.8,1077,2952,363,1440,5,Thursday
6290855005,"2016-04-15 00:00:00",9501,7.18,1112,2896,328,1440,6,Friday
6290855005,"2016-04-16 00:00:00",8301,6.28,1182,2783,258,1440,7,Saturday
6290855005,"2016-04-17 00:00:00",7851,5.94,1172,3171,268,1440,1,Sunday
6290855005,"2016-04-18 00:00:00",6885,5.21,1169,2766,271,1440,2,Monday
6290855005,"2016-04-19 00:00:00",7142,5.4,1119,2839,321,1440,3,Tuesday
6290855005,"2016-04-20 00:00:00",6361,4.81,1182,2701,258,1440,4,Wednesday
6290855005,"2016-04-21 00:00:00",0,0,1440,2060,0,1440,5,Thursday
6290855005,"2016-04-22 00:00:00",6238,4.72,1138,2796,302,1440,6,Friday
6290855005,"2016-04-23 00:00:00",0,0,1407,2664,33,1440,7,Saturday
6290855005,"2016-04-24 00:00:00",5896,4.46,1182,2703,258,1440,1,Sunday
6290855005,"2016-04-25 00:00:00",7802,5.9,1180,2771,260,1440,2,Monday
6290855005,"2016-04-26 00:00:00",0,0,1440,2060,0,1440,3,Tuesday
6290855005,"2016-04-27 00:00:00",5565,4.21,1153,2743,287,1440,4,Wednesday
6290855005,"2016-04-28 00:00:00",5731,4.33,1185,2687,255,1440,5,Thursday
6290855005,"2016-04-29 00:00:00",0,0,1440,2060,0,1440,6,Friday
6290855005,"2016-04-30 00:00:00",6744,5.1,1116,2843,324,1440,7,Saturday
6290855005,"2016-05-01 00:00:00",9837,7.44,1055,3327,385,1440,1,Sunday
6290855005,"2016-05-02 00:00:00",6781,5.13,1172,2725,268,1440,2,Monday
6290855005,"2016-05-03 00:00:00",6047,4.57,1200,2671,240,1440,3,Tuesday
6290855005,"2016-05-04 00:00:00",5832,4.41,1168,2718,272,1440,4,Wednesday
6290855005,"2016-05-05 00:00:00",6339,4.79,1201,2682,239,1440,5,Thursday
6290855005,"2016-05-06 00:00:00",6116,4.62,1135,2806,305,1440,6,Friday
6290855005,"2016-05-07 00:00:00",5510,4.17,1213,2613,227,1440,7,Saturday
6290855005,"2016-05-08 00:00:00",7706,5.83,1189,2712,251,1440,1,Sunday
6290855005,"2016-05-09 00:00:00",6277,4.75,800,2175,264,1064,2,Monday
6290855005,"2016-05-10 00:00:00",0,0,1440,0,0,1440,3,Tuesday
6775888955,"2016-04-12 00:00:00",0,0,1440,1841,0,1440,3,Tuesday
6775888955,"2016-04-13 00:00:00",4053,2.91,1053,2400,120,1173,4,Wednesday
6775888955,"2016-04-14 00:00:00",5162,3.7,863,2507,143,1006,5,Thursday
6775888955,"2016-04-15 00:00:00",1282,0.92,976,2127,58,1034,6,Friday
6775888955,"2016-04-16 00:00:00",4732,3.39,1377,2225,63,1440,7,Saturday
6775888955,"2016-04-17 00:00:00",2497,1.79,1392,2067,48,1440,1,Sunday
6775888955,"2016-04-18 00:00:00",8294,5.95,1233,2798,207,1440,2,Monday
6775888955,"2016-04-19 00:00:00",0,0,1440,1841,0,1440,3,Tuesday
6775888955,"2016-04-20 00:00:00",10771,7.72,1079,3727,361,1440,4,Wednesday
6775888955,"2016-04-21 00:00:00",0,0,1440,1841,0,1440,5,Thursday
6775888955,"2016-04-22 00:00:00",637,0.46,1420,1922,20,1440,6,Friday
6775888955,"2016-04-23 00:00:00",0,0,1440,1841,0,1440,7,Saturday
6775888955,"2016-04-24 00:00:00",2153,1.54,1400,2053,40,1440,1,Sunday
6775888955,"2016-04-25 00:00:00",6474,4.64,1302,2484,138,1440,2,Monday
6775888955,"2016-04-26 00:00:00",7091,5.27,1321,2584,119,1440,3,Tuesday
6775888955,"2016-04-27 00:00:00",0,0,1440,1841,0,1440,4,Wednesday
6775888955,"2016-04-28 00:00:00",703,0.5,1410,1993,30,1440,5,Thursday
6775888955,"2016-04-29 00:00:00",0,0,1440,1841,0,1440,6,Friday
6775888955,"2016-04-30 00:00:00",2503,1.79,1344,2280,96,1440,7,Saturday
6775888955,"2016-05-01 00:00:00",2487,1.78,1347,2319,93,1440,1,Sunday
6775888955,"2016-05-02 00:00:00",0,0,1440,1841,0,1440,2,Monday
6775888955,"2016-05-03 00:00:00",9,0.01,1439,1843,1,1440,3,Tuesday
6775888955,"2016-05-04 00:00:00",0,0,1440,1841,0,1440,4,Wednesday
6775888955,"2016-05-05 00:00:00",0,0,1440,1841,0,1440,5,Thursday
6775888955,"2016-05-06 00:00:00",4697,3.37,1318,2496,122,1440,6,Friday
6775888955,"2016-05-07 00:00:00",1967,1.41,551,1032,56,607,7,Saturday
6962181067,"2016-04-12 00:00:00",10199,6.74,796,1994,253,1049,3,Tuesday
6962181067,"2016-04-13 00:00:00",5652,3.74,548,1718,174,722,4,Wednesday
6962181067,"2016-04-14 00:00:00",1551,1.03,862,1466,86,948,5,Thursday
6962181067,"2016-04-15 00:00:00",5563,3.68,837,1756,217,1054,6,Friday
6962181067,"2016-04-16 00:00:00",13217,8.74,741,2173,333,1074,7,Saturday
6962181067,"2016-04-17 00:00:00",10145,6.71,634,2027,313,947,1,Sunday
6962181067,"2016-04-18 00:00:00",11404,7.54,689,2039,293,982,2,Monday
6962181067,"2016-04-19 00:00:00",10742,7.1,659,2046,271,930,3,Tuesday
6962181067,"2016-04-20 00:00:00",13928,9.55,639,2174,349,988,4,Wednesday
6962181067,"2016-04-21 00:00:00",11835,9.71,708,2179,294,1002,5,Thursday
6962181067,"2016-04-22 00:00:00",10725,7.09,659,2086,303,962,6,Friday
6962181067,"2016-04-23 00:00:00",20031,13.24,484,2571,446,930,7,Saturday
6962181067,"2016-04-24 00:00:00",5029,3.32,720,1705,199,919,1,Sunday
6962181067,"2016-04-25 00:00:00",13239,9.27,637,2194,348,985,2,Monday
6962181067,"2016-04-26 00:00:00",10433,6.9,680,2012,297,977,3,Tuesday
6962181067,"2016-04-27 00:00:00",10320,6.82,697,2034,324,1021,4,Wednesday
6962181067,"2016-04-28 00:00:00",12627,8.35,621,2182,334,955,5,Thursday
6962181067,"2016-04-29 00:00:00",10762,7.11,645,2254,396,1041,6,Friday
6962181067,"2016-04-30 00:00:00",10081,6.66,731,2002,285,1016,7,Saturday
6962181067,"2016-05-01 00:00:00",5454,3.61,722,1740,215,937,1,Sunday
6962181067,"2016-05-02 00:00:00",12912,8.54,655,2162,370,1025,2,Monday
6962181067,"2016-05-03 00:00:00",12109,8.12,654,2072,324,978,3,Tuesday
6962181067,"2016-05-04 00:00:00",10147,6.71,683,2086,335,1018,4,Wednesday
6962181067,"2016-05-05 00:00:00",10524,6.96,591,2066,341,932,5,Thursday
6962181067,"2016-05-06 00:00:00",5908,3.91,717,1850,299,1016,6,Friday
6962181067,"2016-05-07 00:00:00",6815,4.5,745,1947,328,1073,7,Saturday
6962181067,"2016-05-08 00:00:00",4188,2.77,709,1659,165,874,1,Sunday
6962181067,"2016-05-09 00:00:00",12342,8.72,607,2105,295,902,2,Monday
6962181067,"2016-05-10 00:00:00",15448,10.21,626,2361,371,997,3,Tuesday
6962181067,"2016-05-11 00:00:00",6722,4.44,709,1855,230,939,4,Wednesday
6962181067,"2016-05-12 00:00:00",3587,2.37,127,928,113,240,5,Thursday
7007744171,"2016-04-12 00:00:00",14172,10.29,1024,2937,416,1440,3,Tuesday
7007744171,"2016-04-13 00:00:00",12862,9.65,1101,2742,339,1440,4,Wednesday
7007744171,"2016-04-14 00:00:00",11179,8.24,1096,2668,344,1440,5,Thursday
7007744171,"2016-04-15 00:00:00",5273,3.53,1238,2098,202,1440,6,Friday
7007744171,"2016-04-16 00:00:00",4631,3.1,1155,2076,203,1358,7,Saturday
7007744171,"2016-04-17 00:00:00",8059,5.39,1135,2383,305,1440,1,Sunday
7007744171,"2016-04-18 00:00:00",14816,10.98,1077,2832,363,1440,2,Monday
7007744171,"2016-04-19 00:00:00",14194,10.48,1066,2812,374,1440,3,Tuesday
7007744171,"2016-04-20 00:00:00",15566,11.31,1000,3096,440,1440,4,Wednesday
7007744171,"2016-04-21 00:00:00",13744,9.19,1049,2763,391,1440,5,Thursday
7007744171,"2016-04-22 00:00:00",15299,10.24,1065,2889,375,1440,6,Friday
7007744171,"2016-04-23 00:00:00",8093,5.41,1190,2284,250,1440,7,Saturday
7007744171,"2016-04-24 00:00:00",11085,7.42,1021,2667,419,1440,1,Sunday
7007744171,"2016-04-25 00:00:00",18229,13.34,986,3055,454,1440,2,Monday
7007744171,"2016-04-26 00:00:00",15090,10.1,978,2939,462,1440,3,Tuesday
7007744171,"2016-04-27 00:00:00",13541,10.22,1041,2830,399,1440,4,Wednesday
7007744171,"2016-04-28 00:00:00",15128,10.12,1007,2836,433,1440,5,Thursday
7007744171,"2016-04-29 00:00:00",20067,14.3,961,3180,479,1440,6,Friday
7007744171,"2016-04-30 00:00:00",3761,2.52,1240,2051,200,1440,7,Saturday
7007744171,"2016-05-01 00:00:00",5600,3.75,1142,2225,237,1379,1,Sunday
7007744171,"2016-05-02 00:00:00",13041,9.18,1112,2642,328,1440,2,Monday
7007744171,"2016-05-03 00:00:00",14510,10.87,1021,2976,419,1440,3,Tuesday
7007744171,"2016-05-04 00:00:00",0,0,1440,1557,0,1440,4,Wednesday
7007744171,"2016-05-05 00:00:00",15010,11.1,1047,2933,393,1440,5,Thursday
7007744171,"2016-05-06 00:00:00",11459,7.67,1136,2553,304,1440,6,Friday
7007744171,"2016-05-07 00:00:00",0,0,111,120,0,111,7,Saturday
7086361926,"2016-04-12 00:00:00",11317,8.41,745,2772,218,963,3,Tuesday
7086361926,"2016-04-13 00:00:00",5813,3.62,744,2516,212,956,4,Wednesday
7086361926,"2016-04-14 00:00:00",9123,6.12,787,2734,256,1043,5,Thursday
7086361926,"2016-04-15 00:00:00",8585,5.67,864,2395,190,1054,6,Friday
7086361926,"2016-04-16 00:00:00",31,0.01,1437,1635,3,1440,7,Saturday
7086361926,"2016-04-17 00:00:00",0,0,1440,1629,0,1440,1,Sunday
7086361926,"2016-04-18 00:00:00",9827,6.71,1136,2743,226,1362,2,Monday
7086361926,"2016-04-19 00:00:00",10688,7.29,671,2944,260,931,3,Tuesday
7086361926,"2016-04-20 00:00:00",14365,10.64,797,2997,245,1042,4,Wednesday
7086361926,"2016-04-21 00:00:00",9469,6.18,758,2463,231,989,5,Thursday
7086361926,"2016-04-22 00:00:00",9753,6.53,762,2846,270,1032,6,Friday
7086361926,"2016-04-23 00:00:00",2817,1.81,1350,1965,90,1440,7,Saturday
7086361926,"2016-04-24 00:00:00",3520,2.16,566,2049,125,691,1,Sunday
7086361926,"2016-04-25 00:00:00",10091,6.82,706,2752,237,943,2,Monday
7086361926,"2016-04-26 00:00:00",10387,7.07,726,2781,235,961,3,Tuesday
7086361926,"2016-04-27 00:00:00",11107,8.34,829,2693,206,1035,4,Wednesday
7086361926,"2016-04-28 00:00:00",11584,7.8,810,2862,263,1073,5,Thursday
7086361926,"2016-04-29 00:00:00",7881,4.95,1198,2616,242,1440,6,Friday
7086361926,"2016-04-30 00:00:00",14560,9.41,584,2995,367,951,7,Saturday
7086361926,"2016-05-01 00:00:00",12390,8.07,685,2730,303,988,1,Sunday
7086361926,"2016-05-02 00:00:00",10052,6.81,737,2754,231,968,2,Monday
7086361926,"2016-05-03 00:00:00",10288,6.76,761,2754,245,1006,3,Tuesday
7086361926,"2016-05-04 00:00:00",10988,8.31,843,2655,192,1035,4,Wednesday
7086361926,"2016-05-05 00:00:00",8564,5.6,1253,2386,187,1440,5,Thursday
7086361926,"2016-05-06 00:00:00",12461,8.38,834,2924,273,1107,6,Friday
7086361926,"2016-05-07 00:00:00",12827,8.48,621,2739,271,892,7,Saturday
7086361926,"2016-05-08 00:00:00",10677,7.1,695,2534,206,901,1,Sunday
7086361926,"2016-05-09 00:00:00",13566,9.11,743,2960,288,1031,2,Monday
7086361926,"2016-05-10 00:00:00",14433,10.79,1182,2800,201,1383,3,Tuesday
7086361926,"2016-05-11 00:00:00",9572,6.52,757,2735,225,982,4,Wednesday
7086361926,"2016-05-12 00:00:00",3789,2.56,343,1199,67,410,5,Thursday
8053475328,"2016-04-12 00:00:00",18060,14.12,1193,3186,247,1440,3,Tuesday
8053475328,"2016-04-13 00:00:00",16433,13.35,1177,3140,263,1440,4,Wednesday
8053475328,"2016-04-14 00:00:00",20159,15.97,1123,3411,317,1440,5,Thursday
8053475328,"2016-04-15 00:00:00",20669,16.24,1142,3410,298,1440,6,Friday
8053475328,"2016-04-16 00:00:00",14549,11.11,1255,2867,185,1440,7,Saturday
8053475328,"2016-04-17 00:00:00",18827,13.69,1113,3213,327,1440,1,Sunday
8053475328,"2016-04-18 00:00:00",17076,12.66,1137,3133,303,1440,2,Monday
8053475328,"2016-04-19 00:00:00",15929,12.48,1152,3114,288,1440,3,Tuesday
8053475328,"2016-04-20 00:00:00",15108,12.19,695,3043,252,947,4,Wednesday
8053475328,"2016-04-21 00:00:00",16057,12.51,1164,3103,276,1440,5,Thursday
8053475328,"2016-04-22 00:00:00",10520,8.29,1260,2655,180,1440,6,Friday
8053475328,"2016-04-23 00:00:00",22359,17.19,741,3554,362,1103,7,Saturday
8053475328,"2016-04-24 00:00:00",22988,17.95,1096,3577,344,1440,1,Sunday
8053475328,"2016-04-25 00:00:00",20500,15.69,1104,3403,336,1440,2,Monday
8053475328,"2016-04-26 00:00:00",12685,9.62,1182,2846,258,1440,3,Tuesday
8053475328,"2016-04-27 00:00:00",12422,9.82,1187,2852,253,1440,4,Wednesday
8053475328,"2016-04-28 00:00:00",15447,12.4,1188,3062,252,1440,5,Thursday
8053475328,"2016-04-29 00:00:00",12315,9.65,1215,2794,225,1440,6,Friday
8053475328,"2016-04-30 00:00:00",7135,5.59,1281,2408,159,1440,7,Saturday
8053475328,"2016-05-01 00:00:00",1170,0.85,1389,1886,51,1440,1,Sunday
8053475328,"2016-05-02 00:00:00",1969,1.43,1345,1988,95,1440,2,Monday
8053475328,"2016-05-03 00:00:00",15484,11.9,1166,3023,274,1440,3,Tuesday
8053475328,"2016-05-04 00:00:00",14581,11.15,1220,2918,220,1440,4,Wednesday
8053475328,"2016-05-05 00:00:00",14990,11.51,1208,2950,232,1440,5,Thursday
8053475328,"2016-05-06 00:00:00",13953,11,1245,2859,195,1440,6,Friday
8053475328,"2016-05-07 00:00:00",19769,15.67,1076,3331,289,1365,7,Saturday
8053475328,"2016-05-08 00:00:00",22026,17.65,1073,3589,367,1440,1,Sunday
8053475328,"2016-05-09 00:00:00",12465,9.38,1214,2765,226,1440,2,Monday
8053475328,"2016-05-10 00:00:00",14810,11.36,1219,2926,221,1440,3,Tuesday
8053475328,"2016-05-11 00:00:00",12209,9.4,1189,2809,251,1440,4,Wednesday
8053475328,"2016-05-12 00:00:00",4998,3.91,839,1505,71,910,5,Thursday
8253242879,"2016-04-12 00:00:00",9033,7.16,1244,2044,196,1440,3,Tuesday
8253242879,"2016-04-13 00:00:00",8053,6.1,1298,1935,142,1440,4,Wednesday
8253242879,"2016-04-14 00:00:00",5234,3.46,1362,1705,78,1440,5,Thursday
8253242879,"2016-04-15 00:00:00",2672,1.77,1335,1632,105,1440,6,Friday
8253242879,"2016-04-16 00:00:00",9256,6.14,1268,1880,172,1440,7,Saturday
8253242879,"2016-04-17 00:00:00",10204,7.91,1237,2112,203,1440,1,Sunday
8253242879,"2016-04-18 00:00:00",5151,3.48,1278,1829,162,1440,2,Monday
8253242879,"2016-04-19 00:00:00",4212,2.78,1276,1763,164,1440,3,Tuesday
8253242879,"2016-04-20 00:00:00",6466,4.27,1201,1931,239,1440,4,Wednesday
8253242879,"2016-04-21 00:00:00",11268,8.56,1199,2218,241,1440,5,Thursday
8253242879,"2016-04-22 00:00:00",2824,1.87,1320,1651,120,1440,6,Friday
8253242879,"2016-04-23 00:00:00",9282,6.26,1193,2132,247,1440,7,Saturday
8253242879,"2016-04-24 00:00:00",8905,7.13,1313,1976,127,1440,1,Sunday
8253242879,"2016-04-25 00:00:00",6829,4.51,1261,1909,179,1440,2,Monday
8253242879,"2016-04-26 00:00:00",4562,3.04,1299,1813,141,1440,3,Tuesday
8253242879,"2016-04-27 00:00:00",10232,8.18,1286,2008,154,1440,4,Wednesday
8253242879,"2016-04-28 00:00:00",2718,1.8,1393,1580,47,1440,5,Thursday
8253242879,"2016-04-29 00:00:00",6260,4.26,1257,1854,166,1423,6,Friday
8253242879,"2016-04-30 00:00:00",0,0,1440,0,0,1440,7,Saturday
8378563200,"2016-04-12 00:00:00",7626,6.05,723,3635,236,959,3,Tuesday
8378563200,"2016-04-13 00:00:00",12386,9.82,680,4079,299,979,4,Wednesday
8378563200,"2016-04-14 00:00:00",13318,10.56,699,4163,318,1017,5,Thursday
8378563200,"2016-04-15 00:00:00",14461,11.47,729,3666,273,1002,6,Friday
8378563200,"2016-04-16 00:00:00",11207,8.89,563,3363,227,790,7,Saturday
8378563200,"2016-04-17 00:00:00",2132,1.69,599,2572,93,692,1,Sunday
8378563200,"2016-04-18 00:00:00",13630,10.81,720,4157,301,1021,2,Monday
8378563200,"2016-04-19 00:00:00",13070,10.36,737,4092,293,1030,3,Tuesday
8378563200,"2016-04-20 00:00:00",9388,7.44,763,3787,259,1022,4,Wednesday
8378563200,"2016-04-21 00:00:00",15148,12.01,677,4236,298,975,5,Thursday
8378563200,"2016-04-22 00:00:00",12200,9.67,769,4044,284,1053,6,Friday
8378563200,"2016-04-23 00:00:00",5709,4.53,740,2908,165,905,7,Saturday
8378563200,"2016-04-24 00:00:00",3703,2.94,734,2741,135,869,1,Sunday
8378563200,"2016-04-25 00:00:00",12405,9.84,692,4005,274,966,2,Monday
8378563200,"2016-04-26 00:00:00",16208,12.85,593,3763,269,862,3,Tuesday
8378563200,"2016-04-27 00:00:00",7359,5.84,676,3061,200,876,4,Wednesday
8378563200,"2016-04-28 00:00:00",5417,4.3,711,2884,160,871,5,Thursday
8378563200,"2016-04-29 00:00:00",6175,4.9,767,2982,182,949,6,Friday
8378563200,"2016-04-30 00:00:00",2946,2.34,780,2660,121,901,7,Saturday
8378563200,"2016-05-01 00:00:00",11419,9.06,669,3369,208,877,1,Sunday
8378563200,"2016-05-02 00:00:00",6064,4.81,802,3491,209,1011,2,Monday
8378563200,"2016-05-03 00:00:00",8712,6.91,822,3784,286,1108,3,Tuesday
8378563200,"2016-05-04 00:00:00",7875,6.24,680,3110,196,876,4,Wednesday
8378563200,"2016-05-05 00:00:00",8567,6.79,764,3783,283,1047,5,Thursday
8378563200,"2016-05-06 00:00:00",7045,5.59,831,3644,245,1076,6,Friday
8378563200,"2016-05-07 00:00:00",4468,3.54,851,2799,158,1009,7,Saturday
8378563200,"2016-05-08 00:00:00",2943,2.33,621,2685,139,760,1,Sunday
8378563200,"2016-05-09 00:00:00",8382,6.65,772,3721,255,1027,2,Monday
8378563200,"2016-05-10 00:00:00",6582,5.22,840,3586,228,1068,3,Tuesday
8378563200,"2016-05-11 00:00:00",9143,7.25,763,3788,266,1029,4,Wednesday
8378563200,"2016-05-12 00:00:00",4561,3.62,433,1976,116,549,5,Thursday
8583815059,"2016-04-12 00:00:00",5014,3.91,1237,2650,203,1440,3,Tuesday
8583815059,"2016-04-13 00:00:00",5571,4.35,1252,2654,188,1440,4,Wednesday
8583815059,"2016-04-14 00:00:00",3135,2.45,1306,2443,134,1440,5,Thursday
8583815059,"2016-04-15 00:00:00",3430,2.68,1375,2505,65,1440,6,Friday
8583815059,"2016-04-16 00:00:00",5319,4.15,1440,2693,0,1440,7,Saturday
8583815059,"2016-04-17 00:00:00",3008,2.35,1440,2439,0,1440,1,Sunday
8583815059,"2016-04-18 00:00:00",3864,3.01,1309,2536,131,1440,2,Monday
8583815059,"2016-04-19 00:00:00",5697,4.44,1257,2668,183,1440,3,Tuesday
8583815059,"2016-04-20 00:00:00",5273,4.11,1246,2647,194,1440,4,Wednesday
8583815059,"2016-04-21 00:00:00",8538,6.66,1229,2883,211,1440,5,Thursday
8583815059,"2016-04-22 00:00:00",8687,6.78,1170,2944,270,1440,6,Friday
8583815059,"2016-04-23 00:00:00",9423,7.35,1151,3012,289,1440,7,Saturday
8583815059,"2016-04-24 00:00:00",8286,6.46,1188,2889,252,1440,1,Sunday
8583815059,"2016-04-25 00:00:00",4503,3.51,1294,2547,146,1440,2,Monday
8583815059,"2016-04-26 00:00:00",10499,8.19,1134,3093,306,1440,3,Tuesday
8583815059,"2016-04-27 00:00:00",12474,9.73,1229,3142,211,1440,4,Wednesday
8583815059,"2016-04-28 00:00:00",6174,4.82,1209,2757,231,1440,5,Thursday
8583815059,"2016-04-29 00:00:00",15168,11.83,1069,3513,371,1440,6,Friday
8583815059,"2016-04-30 00:00:00",10085,7.87,1093,3164,347,1440,7,Saturday
8583815059,"2016-05-01 00:00:00",4512,3.52,1311,2596,129,1440,1,Sunday
8583815059,"2016-05-02 00:00:00",8469,6.61,1440,2894,0,1440,2,Monday
8583815059,"2016-05-03 00:00:00",12015,9.37,1440,3212,0,1440,3,Tuesday
8583815059,"2016-05-04 00:00:00",3588,2.8,1440,2516,0,1440,4,Wednesday
8583815059,"2016-05-05 00:00:00",12427,9.69,1370,3266,70,1440,5,Thursday
8583815059,"2016-05-06 00:00:00",5843,4.56,1250,2683,190,1440,6,Friday
8583815059,"2016-05-07 00:00:00",6117,4.77,1190,2810,250,1440,7,Saturday
8583815059,"2016-05-08 00:00:00",9217,7.19,1183,2940,257,1440,1,Sunday
8583815059,"2016-05-09 00:00:00",9877,7.7,1260,2947,180,1440,2,Monday
8583815059,"2016-05-10 00:00:00",8240,6.43,1226,2846,214,1440,3,Tuesday
8583815059,"2016-05-11 00:00:00",8701,6.79,1106,2804,253,1359,4,Wednesday
8583815059,"2016-05-12 00:00:00",0,0,1440,0,0,1440,5,Thursday
8792009665,"2016-04-12 00:00:00",2564,1.64,831,2044,116,947,3,Tuesday
8792009665,"2016-04-13 00:00:00",1320,0.84,806,1934,82,888,4,Wednesday
8792009665,"2016-04-14 00:00:00",1219,0.78,853,1963,84,937,5,Thursday
8792009665,"2016-04-15 00:00:00",2483,1.59,937,2009,126,1063,6,Friday
8792009665,"2016-04-16 00:00:00",244,0.16,1428,1721,12,1440,7,Saturday
8792009665,"2016-04-17 00:00:00",0,0,1440,1688,0,1440,1,Sunday
8792009665,"2016-04-18 00:00:00",0,0,1440,1688,0,1440,2,Monday
8792009665,"2016-04-19 00:00:00",0,0,1440,1688,0,1440,3,Tuesday
8792009665,"2016-04-20 00:00:00",3147,2.01,744,2188,149,893,4,Wednesday
8792009665,"2016-04-21 00:00:00",144,0.09,1431,1720,9,1440,5,Thursday
8792009665,"2016-04-22 00:00:00",4068,2.6,817,2419,216,1033,6,Friday
8792009665,"2016-04-23 00:00:00",5245,3.36,795,2748,285,1080,7,Saturday
8792009665,"2016-04-24 00:00:00",400,0.26,1410,1799,30,1440,1,Sunday
8792009665,"2016-04-25 00:00:00",0,0,1440,1688,0,1440,2,Monday
8792009665,"2016-04-26 00:00:00",1321,0.85,1360,1928,80,1440,3,Tuesday
8792009665,"2016-04-27 00:00:00",1758,1.13,900,2067,112,1012,4,Wednesday
8792009665,"2016-04-28 00:00:00",6157,3.94,714,2780,310,1024,5,Thursday
8792009665,"2016-04-29 00:00:00",8360,5.35,634,3101,400,1034,6,Friday
8792009665,"2016-04-30 00:00:00",7174,4.59,749,2896,331,1080,7,Saturday
8792009665,"2016-05-01 00:00:00",1619,1.04,834,1962,79,913,1,Sunday
8792009665,"2016-05-02 00:00:00",1831,1.17,916,2015,101,1017,2,Monday
8792009665,"2016-05-03 00:00:00",2421,1.55,739,2297,156,895,3,Tuesday
8792009665,"2016-05-04 00:00:00",2283,1.46,848,2067,129,977,4,Wednesday
8792009665,"2016-05-05 00:00:00",0,0,1440,1688,0,1440,5,Thursday
8792009665,"2016-05-06 00:00:00",0,0,1440,1688,0,1440,6,Friday
8792009665,"2016-05-07 00:00:00",0,0,1440,1688,0,1440,7,Saturday
8792009665,"2016-05-08 00:00:00",0,0,1440,1688,0,1440,1,Sunday
8792009665,"2016-05-09 00:00:00",0,0,1440,1688,0,1440,2,Monday
8792009665,"2016-05-10 00:00:00",0,0,48,57,0,48,3,Tuesday
8877689391,"2016-04-12 00:00:00",23186,20.4,1036,3921,404,1440,3,Tuesday
8877689391,"2016-04-13 00:00:00",15337,9.58,1098,3566,342,1440,4,Wednesday
8877689391,"2016-04-14 00:00:00",21129,18.98,1061,3793,379,1440,5,Thursday
8877689391,"2016-04-15 00:00:00",13422,7.17,1052,3934,388,1440,6,Friday
8877689391,"2016-04-16 00:00:00",29326,25.29,888,4547,552,1440,7,Saturday
8877689391,"2016-04-17 00:00:00",15118,8.87,1060,3545,380,1440,1,Sunday
8877689391,"2016-04-18 00:00:00",11423,8.67,1215,2761,225,1440,2,Monday
8877689391,"2016-04-19 00:00:00",18785,17.4,1131,3676,309,1440,3,Tuesday
8877689391,"2016-04-20 00:00:00",19948,18.11,1123,3679,317,1440,4,Wednesday
8877689391,"2016-04-21 00:00:00",19377,17.62,1119,3659,321,1440,5,Thursday
8877689391,"2016-04-22 00:00:00",18258,16.31,1141,3427,299,1440,6,Friday
8877689391,"2016-04-23 00:00:00",11200,7.43,1032,3891,408,1440,7,Saturday
8877689391,"2016-04-24 00:00:00",16674,15.74,1148,3455,292,1440,1,Sunday
8877689391,"2016-04-25 00:00:00",12986,8.74,1101,3802,339,1440,2,Monday
8877689391,"2016-04-26 00:00:00",11101,8.43,1157,2860,283,1440,3,Tuesday
8877689391,"2016-04-27 00:00:00",23629,20.65,1104,3808,336,1440,4,Wednesday
8877689391,"2016-04-28 00:00:00",14890,11.3,1143,3060,297,1440,5,Thursday
8877689391,"2016-04-29 00:00:00",9733,7.39,1207,2698,233,1440,6,Friday
8877689391,"2016-04-30 00:00:00",27745,26.72,1089,4398,351,1440,7,Saturday
8877689391,"2016-05-01 00:00:00",10930,8.32,1226,2786,214,1440,1,Sunday
8877689391,"2016-05-02 00:00:00",4790,3.64,1335,2189,105,1440,2,Monday
8877689391,"2016-05-03 00:00:00",10818,8.21,1189,2817,251,1440,3,Tuesday
8877689391,"2016-05-04 00:00:00",18193,16.3,1154,3477,286,1440,4,Wednesday
8877689391,"2016-05-05 00:00:00",14055,10.67,1170,3052,270,1440,5,Thursday
8877689391,"2016-05-06 00:00:00",21727,19.34,1095,4015,345,1440,6,Friday
8877689391,"2016-05-07 00:00:00",12332,8.13,1036,4142,404,1440,7,Saturday
8877689391,"2016-05-08 00:00:00",10686,8.11,1174,2847,266,1440,1,Sunday
8877689391,"2016-05-09 00:00:00",20226,18.25,1131,3710,309,1440,2,Monday
8877689391,"2016-05-10 00:00:00",10733,8.15,1187,2832,253,1440,3,Tuesday
8877689391,"2016-05-11 00:00:00",21420,19.56,1127,3832,313,1440,4,Wednesday
8877689391,"2016-05-12 00:00:00",8064,6.12,770,1849,161,931,5,Thursday
